S  +++++++++++++
            +  +
+  +++++++  +  +
+        +     +
+  +++++++++++++
+        +     +
+++++++  +  ++++
+              +
+  +++++++  ++++
+        +     E
+++++++++++++ 
